2  2  2  2  2  2  2  2  2  2  2  2  2  2  2
2  0  0  0  3  0  1  0  0  1  0  1  0  0  2
2  0  0  0  0  0  0  0  0  1  0  2  0  0  2
2  0  0  0  3  0 71  2  0  1  0  1  0  0  2
2 72  0  1  3  0  2  0 71 51  0  1  0  0  2
2  0  0  1  3  0  0  0  1  0  0  0  0  0  2
2  1  0  1  3  3  0  3  3  3  3  0  0  1  2
2  0  0  0 71  0  0  0  4  0  3  0 52 52  2
2  1  1 61  1  0  2  4  4  4  3  0 71 71  2
2 51  0 61  1  0  1  4  4  4  3  0  1  0  2
2  0 72  0  0  0  1  0  4  0  3  0  4  0  2
2  0  1  0 72  0 51 51 51  0  0  4  4  4  2
2  0  1  0  1  0 41 71 31  0  3  4  4  4  2
2  0  0  0  0  6 61  5 81  6  3  0  4  0  2
2  2  2  2  2  2  2  2  2  2  2  2  2  2  2