#title=Речной тоннель
2  2  2  2  2  2  2  2  2  2  2  2  2  2  2  2  2  2  2  2
2  0  1  0  0  4  0  1  4  4  4  1  0  0  0  1  1  0  0  2
2  6  4  4  4  4  1  1  3  4  4  4  0  1  0  3  1  1  7  2
2  1  1  4  4  4  0  1  3  4  4  4  1  1  4  3  0  0  0  2
2  5  1  4  3  3  3  3  3  3  3  0  4  4  4  3  1  4  7  2
2  1  1  0  0  0  1  1  1  1  3  0  4  4  3  3  1  4  4  2
2  6  0  0  1  0  1  0  1  1  3  3  3  3  3  0  0  0  7  2
2  4  4  1  1  0  0  0  1  1  1  0  0  0  1  1  0  3  0  2
2  4  4  0  0  0  1  0  0  1  1  1  0  3  1  1  1  0  0  2
2  2  2  2  2  2  2  2  2  2  2  2  2  2  2  2  2  2  2  2