#title=Тестовая карта - троечка
#max_players=3
2  2  2  2  2  2  2
2  0  0  7  0  0  2
2  0  0  0  0  0  2
2  0  0  2  0  0  2
2  0  0  0  0  0  2
2  0  0  0  0  0  2
2  0  0  0  0  0  2
2  0  0  0  0  0  2
2  0  0  0  0  0  2
2  0  0  0  0  0  2
2  0  0  6  0  0  2
2  0 51 51 51  0  2
2  0 41 71 31  0  2
2  6 61  5 81  6  2
2  2  2  2  2  2  2